5 13 31
###############################
#p * *   1    *  ** * *   2  *#
# # # # #*# # #*# # # # # #*# #
#*   *  5  * **  4   *    **  #
# #*# # # # # # #b# # # # # #*#
#*   * 3   *  1  **  3   *  **#
# # #*# # # # # #*#*#*#*#*#*#*#
#   *  4 * s *   * *x* *  2   #
# # # # #*# # # # # # #*#*#*#*#
#   * 3*   5     *  *  *  2   #
# # # # # # # # # #*# #*#*#*#*#
#  ** *   *  4   *   *   1    #
###############################