3 13 31
###############################
#p * *   1    *  ** * *   2  *#
# # # # #*# # #*# # # # # #*# #
# *  * f *x* **      *    **  #
# #*# # # # # # #b# # # # # #*#
#*         *  1  **      *  **#
# # #*# # # # # #*#*#*#*#*#*#*#
#   * 3*     *   * * * *  2   #
# # # # #*# # # # # # #*#*#*#*#
#   ****         *  *  *  2   #
# # # # # # # # # #*# #*#*#*#*#
#  ** *   *   4  *   *   1    #
###############################