2 13 31
###############################
#p * *   1    *  ** * *   2  *#
# # # # #*# # #*# # # # # #*# #
#    * f *** **      *    **  #
# #*# # # # # # #b# # # # # #*#
#          *  1  **      *  **#
# # #*# # # # # #*#*#*#*#*#*#*#
#   *        *   * *x* *  2   #
# # # # #*# # # # # # #*#*#*#*#
#   ****         *  *  *  2   #
# # # # # # # # # #*# #*#*#*#*#
#  ** *   *      *   *   1    #
###############################